Fnuc'rtnchvxo. 63

Laciniae praesertim Monopbyllis numeratae,
Integer: Genipa.
Bifidus: Utricularia.
Trifidus: Altsma, Cliffortia.
Ouadrifidus: Rhinanthus.
Ouinquefidus: Nicetiana.
Sexfidus τ Parit.
OCKOfldus: Tormemilla.

. Decenlfidtlss. Potentilla. Fragan’a.

Duodeccmfidus: Lythrum.

AEqual. AEqualis. chhnis.
Inaequalis: Helianthemum. Tournef.
alternis brevioribus, nummula, Potentilla.

ffi'gura: Globosus: Caeubalus.
Clavatus: Silene,
Reflexus: Asclepius.
Erectus: Primula, Nicetiana.

Astu-go: Integerrimus: Plerisque.
serratus: Hyperia-i species.
Ciliatus: Centaurea? sp.

Apex .· Acutus: Primulo, Androsaee.
AcuminatuS, Hyosciamus.
obtusus: Nvmpheassarcinia. ”
Unico denticulo truncato: Verbena.

Pr0p0r1i02C0rolla longior: Agrostema‚ Sagina‚ Amirrhini sp, ,
corollae aequalis: Cerastii sp. '
Corolla brevior: .s·1·1ene.

Locus ε F loris: Litvzaea, Morina.

FruCtus: Linnaea, Morina.
Fruffificationis: PaeoniJ.
Duratio.- Cadmus, ad primam explicationem Floris: Pa·
panter, E imedium.
Deciduus cum orolla; Tetradynamia, Berberis,
Perfistens ad maturitatem fruetus: Didynamia,

INVOLUCRUM Monophynnm: Bupleurum.
Diphyllum z Euphorbia.
Triphyllum: Ennomus, Alsjhza.
Tetraphyllum: Cornus,
Pentaphyssum: Daucue.
Hexaphyllum: Haemamlzus.

SPA-

