66

ancrzrxcavxo.
chs in fingulo filamentor Γωηανία. ·
. Qu-mque in tribus filmer-ris: [monia.
m fingUJO filanxcnto: il‘heohroma.
Loculo unico: Mercurialis.
gemino: Helles-erus.
trino: Orchis. ¹ ”
quaterno: laddum-ia.
Desec‘t‘u unius: Chelone, Marrynia.
Duorum: binga-icum , Vcrbena.
Trium : (ipatiols, Bignoniae,‹;erani2.
Quatuor: Curcuma. ‘

ο Quinque: Pantapetes, Gerania.
thura oblonga: Laium.

Globosa: Mercurialis.
Sagittata: Crocus.
Angulata: Tulipa.
‚Cornutaz Hamamelfs, Erico, V affinia, Pyrola.
Dehglbentia Latere: Plerique, Leucojam.
Apice: <13 lam-hus, Κίρρα ἀνία.
a bafi ad A. ›icem discedens: Epi-
· nze( ium, Leontice. “
Connexzone Apice: Colchicmn.
Bafi': Plerique.
Latere : 'Canna
, Nestario: Cqstus.
δύω in Filamentis apice : Plerique.
' latere : Paris, Asanam.
Pistillo: Aristolochioe.
Receptaculo: Arum.

Pomm< figura:}s'g10bus echinatu's: Helianthus.

perforatus: Geranium.
didymus: Symphyeum.
rotatus dentatus: Malva.
angulatus: Viola.
renifo'rmis: Nar-ciffus.
Philyra· convoluta : Borrago.

102. Ph

